Level 1
Getting Started
0,0,0,0,0,0,0,0,0,0,0,0,0,0,0,0,0,0,0,0
0,0,0,0,0,0,0,0,0,0,0,0,0,0,0,0,0,0,0,0
0,0,0,0,0,0,0,0,0,0,0,0,0,0,0,0,0,0,0,0
0,0,0,1,1,1,1,1,2,2,2,3,3,3,3,1,1,0,0,0
0,0,0,1,1,1,1,2,2,3,3,3,3,3,1,1,1,0,0,0
0,0,0,1,1,1,2,2,2,2,2,3,3,1,1,1,1,0,0,0
0,0,0,1,1,2,2,2,3,3,3,3,1,1,1,1,1,0,0,0
0,0,0,0,0,0,0,0,0,0,0,0,0,0,0,0,0,0,0,0
0,0,0,0,0,0,0,0,0,0,0,0,0,0,0,0,0,0,0,0
0,0,0,0,0,0,0,0,0,0,0,0,0,0,0,0,0,0,0,0
