Level 5
Dun Dun DUUUN
0,0,0,0,0,3,3,3,3,3,3,3,3,0,0,0,0,0
0,0,0,0,3,3,3,3,3,3,3,3,3,3,0,0,0,0
0,0,0,3,3,3,3,3,3,3,3,3,3,3,3,0,0,0
0,0,0,3,3,1,1,3,3,3,3,1,1,3,3,0,0,0
0,0,0,3,3,1,1,1,3,3,1,1,1,3,3,0,0,0
0,0,0,3,3,3,3,3,3,3,3,3,3,3,3,0,0,0
0,0,0,0,3,3,3,3,1,1,3,3,3,3,0,0,0,0
0,0,0,0,0,3,3,3,3,3,3,3,3,0,0,0,0,0
0,0,0,0,0,-1,2,-1,3,-1,3,-1,3,0,0,0,0,0
